{
  "hero":{
    "name": "tofe",
    "scale": 32,
    "x":1, "y":21
  },

  "enemies": [
    {
      "name": "boss",
      "scale": 32,
      "positions": [
{ "x":8, "y":21, "id":33 }
]
    },
    {
      "name": "maniac",
      "scale": 32,
      "positions": [
          { "x":28, "y":113, "id":20 },
          { "x":28, "y":154, "id":20 },
          { "x":30, "y":102, "id":20 },
          { "x":33, "y":76, "id":20 },
          { "x":33, "y":168, "id":20 },
          { "x":34, "y":134, "id":20 },
          { "x":34, "y":142, "id":20 },
          { "x":35, "y":162, "id":20 },
          { "x":36, "y":104, "id":20 },
          { "x":36, "y":111, "id":20 },
          { "x":36, "y":125, "id":20 },
          { "x":36, "y":148, "id":20 },
          { "x":36, "y":154, "id":20 },
          { "x":39, "y":118, "id":20 },
          { "x":45, "y":103, "id":20 },
          { "x":45, "y":131, "id":20 },
          { "x":47, "y":141, "id":20 }
      ]
    },
    {
      "name": "dummy",
      "scale": 32,
      "positions": [
          { "x":25, "y":26, "id":17 },
          { "x":25, "y":33, "id":17 },
          { "x":25, "y":42, "id":17 },
          { "x":25, "y":48, "id":17 },
          { "x":25, "y":58, "id":17 },
          { "x":25, "y":65, "id":17 },
          { "x":25, "y":68, "id":17 },
          { "x":25, "y":77, "id":17 },
          { "x":25, "y":85, "id":17 },
          { "x":27, "y":99, "id":17 },
          { "x":28, "y":108, "id":17 },
          { "x":29, "y":138, "id":17 },
          { "x":29, "y":139, "id":17 },
          { "x":30, "y":125, "id":17 },
          { "x":30, "y":139, "id":17 },
          { "x":30, "y":158, "id":17 },
          { "x":30, "y":168, "id":17 },
          { "x":31, "y":71, "id":17 },
          { "x":31, "y":80, "id":17 },
          { "x":31, "y":87, "id":17 },
          { "x":31, "y":116, "id":17 },
          { "x":32, "y":151, "id":17 },
          { "x":33, "y":151, "id":17 },
          { "x":33, "y":152, "id":17 },
          { "x":33, "y":162, "id":17 },
          { "x":37, "y":143, "id":17 },
          { "x":37, "y":144, "id":17 },
          { "x":38, "y":134, "id":17 },
          { "x":38, "y":135, "id":17 },
          { "x":39, "y":100, "id":17 },
          { "x":39, "y":157, "id":17 },
          { "x":40, "y":107, "id":17 },
          { "x":40, "y":108, "id":17 },
          { "x":41, "y":127, "id":17 },
          { "x":41, "y":167, "id":17 },
          { "x":42, "y":163, "id":17 },
          { "x":43, "y":153, "id":17 },
          { "x":44, "y":100, "id":17 },
          { "x":44, "y":116, "id":17 },
          { "x":44, "y":152, "id":17 },
          { "x":44, "y":153, "id":17 },
          { "x":45, "y":79, "id":17 },
          { "x":45, "y":149, "id":17 },
          { "x":45, "y":150, "id":17 },
          { "x":45, "y":151, "id":17 },
          { "x":45, "y":152, "id":17 },
          { "x":46, "y":145, "id":17 },
          { "x":47, "y":111, "id":17 },
          { "x":49, "y":22, "id":17 },
          { "x":49, "y":39, "id":17 },
          { "x":49, "y":44, "id":17 },
          { "x":49, "y":53, "id":17 },
          { "x":49, "y":61, "id":17 },
          { "x":49, "y":73, "id":17 },
          { "x":49, "y":81, "id":17 },
          { "x":49, "y":89, "id":17 }
  ]
    },
    {
      "name": "turret",
      "scale": 32,
      "positions": [
          { "x":26, "y":131, "id":16 },
          { "x":27, "y":142, "id":16 },
          { "x":27, "y":144, "id":16 },
          { "x":27, "y":163, "id":16 },
          { "x":28, "y":148, "id":16 },
          { "x":29, "y":147, "id":16 },
          { "x":29, "y":156, "id":16 },
          { "x":32, "y":157, "id":16 },
          { "x":32, "y":158, "id":16 },
          { "x":33, "y":51, "id":16 },
          { "x":33, "y":129, "id":16 },
          { "x":34, "y":129, "id":16 },
          { "x":36, "y":136, "id":16 },
          { "x":36, "y":167, "id":16 },
          { "x":38, "y":163, "id":16 },
          { "x":39, "y":59, "id":16 },
          { "x":39, "y":151, "id":16 },
          { "x":39, "y":152, "id":16 },
          { "x":40, "y":74, "id":16 },
          { "x":41, "y":125, "id":16 },
          { "x":42, "y":86, "id":16 },
          { "x":42, "y":126, "id":16 },
          { "x":42, "y":144, "id":16 },
          { "x":43, "y":55, "id":16 },
          { "x":44, "y":48, "id":16 },
          { "x":44, "y":137, "id":16 },
          { "x":44, "y":139, "id":16 },
          { "x":45, "y":135, "id":16 },
          { "x":45, "y":160, "id":16 }
      ]
    }
  ]

}